year,team_id,team_name,wins,losses,ties,total_games
2021,26172,A&M-Corpus Christi,4,17,0,21
2021,2,Abilene Christian,19,3,0,22
2021,30123,Academy of Art,2,6,0,8
2021,929,Adams St.,8,9,0,17
2021,4,Adrian,2,13,0,15
2021,721,Air Force,5,17,0,22
2021,5,Akron,14,5,0,19
2021,10,Alabama Huntsville,12,2,0,14
2021,8,Alabama,18,6,0,24
2021,6,Alabama A&M,6,5,0,11
2021,7,Alabama St.,4,9,0,13
2021,14,Albany (NY),6,8,0,14
2021,13,Albany St. (GA),2,5,0,7
2021,15,Albion,8,2,0,10
2021,16,Albright,1,1,0,2
2021,17,Alcorn,5,9,0,14
2021,934,Alderson Broaddus,6,8,0,14
2021,21,Alma,2,10,0,12
2021,23,American,2,5,0,7
2021,22,American Int'l,0,4,0,4
2021,939,Anderson (IN),7,5,0,12
2021,13028,Anderson (SC),6,11,0,17
2021,25,Angelo St.,6,9,0,15
2021,27,App State,12,10,0,22
2021,966,Arcadia,3,1,0,4
2021,29,Arizona,15,8,0,23
2021,28,Arizona St.,8,11,0,19
2021,30105,Ark.-Fort Smith,4,10,0,14
2021,8411,Ark.-Monticello,11,4,0,15
2021,2678,Ark.-Pine Bluff,3,18,0,21
2021,31,Arkansas,18,5,0,23
2021,30,Arkansas St.,10,10,0,20
2021,947,Arkansas Tech,6,9,0,15
2021,725,Army West Point,10,7,0,17
2021,35,Ashland,9,8,0,17
2021,37,Auburn,11,13,0,24
2021,38,Augsburg,2,2,0,4
2021,39,Augusta,9,6,0,15
2021,40,Augustana (IL),5,3,0,8
2021,41,Augustana (SD),9,6,0,15
2021,30093,AUM,3,12,0,15
2021,42,Aurora,5,3,0,8
2021,953,Austin,3,4,0,7
2021,43,Austin Peay,14,10,0,24
2021,44,Averett,5,5,0,10
2021,30146,Azusa Pacific,5,5,0,10
2021,45,Babson,2,0,0,2
2021,46,Baldwin Wallace,2,6,0,8
2021,47,Ball St.,8,11,0,19
2021,49,Barry,1,0,0,1
2021,15646,Barton,4,8,0,12
2021,51,Baylor,18,0,0,18
2021,30197,Belhaven,3,12,0,15
2021,52,Bellarmine,13,5,0,18
2021,14927,Belmont,24,1,0,25
2021,2683,Belmont Abbey,16,4,0,20
2021,54,Bemidji St.,7,9,0,16
2021,55,Benedict,5,1,0,6
2021,296,Benedictine (IL),8,2,0,10
2021,30171,Berea,0,8,0,8
2021,973,Berry,9,1,0,10
2021,59,Bethany (WV),0,6,0,6
2021,30038,Bethany Lutheran,4,2,0,6
2021,60,Bethel (MN),2,3,0,5
2021,62,Binghamton,4,13,0,17
2021,30220,Biola,6,3,0,9
2021,28593,Birmingham-So.,9,5,0,14
2021,30134,Black Hills St.,9,5,0,14
2021,984,Bloomfield,6,3,0,9
2021,985,Bluefield St.,1,5,1,7
2021,987,Bluffton,11,4,0,15
2021,66,Boise St.,18,4,0,22
2021,67,Boston College,3,13,0,16
2021,68,Boston U.,5,9,0,14
2021,71,Bowling Green,13,9,0,22
2021,72,Bradley,11,14,0,25
2021,30094,Brevard,0,5,0,5
2021,75,Bridgewater (VA),2,4,0,6
2021,81,Bryant,12,5,0,17
2021,83,Bucknell,4,4,0,8
2021,84,Buena Vista,6,1,0,7
2021,86,Buffalo,10,7,0,17
2021,87,Butler,8,13,0,21
2021,77,BYU,17,5,0,22
2021,1305,Cairn,2,2,1,5
2021,90,Cal Poly,3,15,0,18
2021,97,Cal St. Fullerton,6,7,0,13
2021,995,Caldwell,5,4,0,9
2021,107,California,8,17,0,25
2021,30135,California Baptist,11,8,0,19
2021,114,Calvin,6,3,0,9
2021,996,Cameron,1,14,0,15
2021,115,Campbell,15,9,0,24
2021,116,Canisius,6,4,0,10
2021,117,Capital,4,4,0,8
2021,120,Carroll (WI),3,6,0,9
2021,1000,Carson-Newman,13,5,0,18
2021,121,Carthage,4,5,0,9
2021,123,Castleton,0,1,0,1
2021,1001,Catawba,8,11,0,19
2021,124,Catholic,4,3,0,7
2021,30124,Cedarville,10,8,0,18
2021,125,Centenary (LA),6,2,0,8
2021,126,Central (IA),2,2,0,4
2021,1004,Central Ark.,3,17,0,20
2021,127,Central Conn. St.,4,15,0,19
2021,129,Central Mich.,6,13,0,19
2021,130,Central Mo.,6,14,0,20
2021,1009,Central Okla.,10,10,0,20
2021,1010,Central Wash.,0,2,0,2
2021,132,Centre,3,3,0,6
2021,1012,Chadron St.,5,5,0,10
2021,133,Chaminade,3,5,0,8
2021,1013,Charleston (WV),12,2,1,15
2021,48,Charleston So.,3,18,0,21
2021,458,Charlotte,9,11,0,20
2021,10972,Chatham,4,3,0,7
2021,693,Chattanooga,18,7,0,25
2021,136,Chicago St.,0,9,0,9
2021,8875,Chowan,4,8,0,12
2021,139,Chris. Newport,1,0,0,1
2021,1015,Christian Brothers,2,10,0,12
2021,140,Cincinnati,8,8,0,16
2021,143,Clarion,2,6,0,8
2021,146,Clarkson,1,2,1,4
2021,20576,Clayton St.,0,9,1,10
2021,147,Clemson,14,5,0,19
2021,148,Cleveland St.,16,7,0,23
2021,149,Coastal Carolina,13,6,0,19
2021,150,Coe,5,5,0,10
2021,1023,Coker,4,11,0,15
2021,1014,Col. of Charleston,9,9,0,18
2021,153,Colgate,11,1,0,12
2021,11403,Colo. Christian,2,15,0,17
2021,155,Colo. Sch. of Mines,13,1,0,14
2021,157,Colorado,17,7,0,24
2021,154,Colorado Col.,0,6,0,6
2021,11416,Colorado Mesa,16,1,0,17
2021,156,Colorado St.,14,4,0,18
2021,2720,CSU Pueblo,3,14,0,17
2021,159,Columbus St.,5,7,0,12
2021,1028,Concord,8,6,0,14
2021,30199,Concordia (CA),1,11,0,12
2021,162,Concordia (NY),2,4,1,7
2021,24400,Concordia (TX),3,4,0,7
2021,160,Concordia Chicago,2,10,0,12
2021,1036,Concordia Wisconsin,5,4,0,9
2021,161,Concordia-M'head,0,3,0,3
2021,9081,Concordia-St. Paul,1,13,0,14
2021,165,Coppin St.,7,12,0,19
2021,166,Cornell College,2,3,0,5
2021,30111,Covenant,8,10,0,18
2021,169,Creighton,17,5,0,22
2021,30035,Crown (MN),3,7,0,10
2021,94,CSU Bakersfield,14,9,0,23
2021,101,CSUN,8,9,0,17
2021,1059,D'Youville,1,11,0,12
2021,30174,Daemen,6,3,0,9
2021,1044,Dallas,2,6,0,8
2021,30221,Davenport,5,11,0,16
2021,173,Davidson,11,7,0,18
2021,174,Davis & Elkins,3,10,0,13
2021,175,Dayton,12,8,0,20
2021,1045,DBU,13,3,0,16
2021,1050,Defiance,1,5,0,6
2021,180,Delaware,7,7,0,14
2021,178,Delaware St.,2,13,0,15
2021,179,Delaware Valley,0,3,0,3
2021,181,Delta St.,4,7,0,11
2021,182,Denison,3,2,0,5
2021,183,Denver,2,17,0,19
2021,176,DePaul,4,11,0,15
2021,177,DePauw,8,1,0,9
2021,20,DeSales,4,0,0,4
2021,184,Detroit Mercy,11,9,0,20
2021,30095,Dixie St.,8,11,0,19
2021,30118,Dominican (CA),2,3,0,5
2021,1332,Dominican (IL),1,6,0,7
2021,8956,Dominican (NY),4,3,0,7
2021,189,Drake,23,2,0,25
2021,190,Drew,4,1,0,5
2021,191,Drexel,8,7,0,15
2021,1057,Drury,9,9,0,18
2021,192,Dubuque,9,0,0,9
2021,193,Duke,11,8,0,19
2021,194,Duquesne,7,8,0,15
2021,195,Earlham,1,7,0,8
2021,196,East Carolina,8,8,0,16
2021,8965,East Central,8,7,0,15
2021,1062,East Tex. Baptist,12,8,0,20
2021,203,East. Mennonite,2,1,0,3
2021,200,Eastern Conn. St.,5,3,0,8
2021,201,Eastern Ill.,9,16,0,25
2021,202,Eastern Ky.,19,6,0,25
2021,204,Eastern Mich.,4,10,0,14
2021,207,Eastern Wash.,12,6,0,18
2021,1066,Edgewood,7,6,0,13
2021,212,Elmhurst,5,1,0,6
2021,1068,Elon,6,8,0,14
2021,30193,Emmanuel (GA),13,5,0,18
2021,216,Emory & Henry,0,7,0,7
2021,1071,Emporia St.,10,11,0,21
2021,1072,Erskine,2,12,0,14
2021,198,ETSU,12,10,0,22
2021,218,Eureka,2,0,0,2
2021,219,Evansville,8,14,0,22
2021,220,Fairfield,6,15,0,21
2021,222,Fairleigh Dickinson,8,14,0,22
2021,1076,Fairmont St.,10,4,0,14
2021,221,FDU-Florham,0,4,0,4
2021,23157,Felician,4,4,1,9
2021,224,Ferris St.,8,9,0,17
2021,225,Ferrum,6,5,0,11
2021,28755,FGCU,9,6,0,15
2021,1079,Findlay,17,4,0,21
2021,30032,Finlandia,0,6,0,6
2021,231,FIU,9,15,0,24
2021,229,Fla. Atlantic,8,9,0,17
2021,233,Fla. Southern,1,2,0,3
2021,30092,Flagler,12,5,0,17
2021,235,Florida,12,6,0,18
2021,228,Florida A&M,5,9,0,14
2021,234,Florida St.,14,3,0,17
2021,230,Florida Tech,0,1,0,1
2021,11538,Fontbonne,0,3,0,3
2021,236,Fordham,2,11,0,13
2021,9011,Fort Hays St.,12,10,0,22
2021,1083,Fort Lewis,6,7,0,13
2021,237,Fort Valley St.,0,2,0,2
2021,1085,Francis Marion,3,10,0,13
2021,30069,Franciscan,2,4,0,6
2021,2694,Franklin,6,6,0,12
2021,30147,Fresno Pacific,6,6,0,12
2021,96,Fresno St.,10,9,0,19
2021,243,Frostburg St.,4,10,0,14
2021,244,Furman,16,7,0,23
2021,253,Ga. Southern,12,11,0,23
2021,1097,Ga. Southwestern,12,4,0,16
2021,246,Gannon,9,2,0,11
2021,1092,Gardner-Webb,11,14,0,25
2021,30084,Geneva,5,2,0,7
2021,1094,George Fox,0,1,0,1
2021,248,George Mason,11,8,0,19
2021,249,George Washington,4,10,0,14
2021,251,Georgetown,7,11,0,18
2021,257,Georgia,14,9,0,23
2021,1096,Georgia College,9,2,0,11
2021,254,Georgia St.,12,5,0,17
2021,255,Georgia Tech,12,8,0,20
2021,9004,Georgian Court,2,5,0,7
2021,1098,Glenville St.,7,2,1,10
2021,260,Gonzaga,22,0,0,22
2021,261,Grambling,9,10,0,19
2021,1104,Grand Canyon,13,4,0,17
2021,262,Grand Valley St.,9,6,0,15
2021,794,Green Bay,8,16,0,24
2021,263,Greensboro,7,13,0,20
2021,1111,Greenville,1,6,0,7
2021,265,Grove City,3,2,0,5
2021,1112,Guilford,2,1,0,3
2021,266,Gust. Adolphus,1,2,0,3
2021,268,Hamline,2,4,0,6
2021,269,Hampden-Sydney,2,4,0,6
2021,270,Hampton,10,13,0,23
2021,1115,Hanover,7,4,0,11
2021,271,Hardin-Simmons,13,7,0,20
2021,1116,Harding,4,8,0,12
2021,272,Hartford,11,8,0,19
2021,277,Hawaii,8,8,0,16
2021,2697,Hawaii Hilo,8,2,0,10
2021,2696,Hawaii Pacific,2,8,0,10
2021,278,Heidelberg,7,2,0,9
2021,1123,Henderson St.,8,7,0,15
2021,1124,Hendrix,2,4,0,6
2021,19651,High Point,8,14,0,22
2021,280,Hillsdale,18,1,0,19
2021,283,Hofstra,12,9,0,21
2021,285,Holy Cross,5,11,0,16
2021,286,Hope,4,4,0,8
2021,288,Houston,18,3,0,21
2021,287,Houston Baptist,4,15,0,19
2021,290,Howard,1,4,0,5
2021,2741,Howard Payne,0,19,0,19
2021,1130,Huntingdon,4,8,0,12
2021,1133,Husson,4,0,0,4
2021,295,Idaho,0,19,0,19
2021,294,Idaho St.,12,7,0,19
2021,300,Ill. Wesleyan,4,0,0,4
2021,30050,Ill. Springfield,7,12,0,19
2021,301,Illinois,16,6,0,22
2021,297,Illinois Col.,3,1,0,4
2021,299,Illinois St.,7,15,0,22
2021,2743,UIW,8,10,0,18
2021,306,Indiana,12,11,0,23
2021,305,Indiana St.,13,8,0,21
2021,310,Iona,8,5,0,13
2021,312,Iowa,17,6,0,23
2021,311,Iowa St.,2,17,0,19
2021,30173,Iowa Wesleyan,1,3,0,4
2021,2699,IUPUI,8,9,0,17
2021,314,Jackson St.,7,5,0,12
2021,316,Jacksonville,11,13,0,24
2021,315,Jacksonville St.,15,8,0,23
2021,317,James Madison,13,5,0,18
2021,320,John Carroll,2,3,0,5
2021,325,Juniata,3,3,0,6
2021,326,Kalamazoo,3,3,0,6
2021,328,Kansas,17,8,0,25
2021,327,Kansas St.,7,18,0,25
2021,329,Kean,1,5,0,6
2021,330,Keene St.,5,3,0,8
2021,1157,Kennesaw St.,4,18,0,22
2021,331,Kent St.,14,6,0,20
2021,334,Kentucky,8,13,0,21
2021,332,Kentucky St.,0,4,0,4
2021,30051,King (TN),6,11,0,17
2021,333,Ky. Wesleyan,10,5,0,15
2021,340,La Salle,9,14,0,23
2021,498,ULM,7,16,0,23
2021,342,Lafayette,7,5,0,12
2021,1162,LaGrange,6,2,0,8
2021,2746,Lake Erie,4,11,0,15
2021,344,Lake Forest,0,3,0,3
2021,345,Lake Superior St.,8,8,0,16
2021,1164,Lakeland,7,5,0,12
2021,346,Lamar University,5,17,0,22
2021,30085,Lancaster Bible,5,4,0,9
2021,1167,Lander,6,10,0,16
2021,351,Lebanon Valley,3,0,0,3
2021,30013,Lee,11,5,0,16
2021,13302,Lees-McRae,5,4,0,9
2021,352,Lehigh,4,8,0,12
2021,1170,Lenoir-Rhyne,8,6,0,14
2021,8490,LeTourneau,6,7,0,13
2021,354,Lewis,9,11,0,20
2021,355,Liberty,19,5,0,24
2021,1174,Limestone,2,12,0,14
2021,356,Lincoln (MO),11,9,0,20
2021,357,Lincoln (PA),3,2,0,5
2021,1176,Lincoln Memorial,16,3,0,19
2021,30136,Lindenwood (MO),10,8,0,18
2021,28600,Lipscomb,15,10,0,25
2021,32,Little Rock,10,13,0,23
2021,361,LIU,9,7,0,16
2021,370,LMU (CA),11,7,0,18
2021,99,Long Beach St.,5,7,0,12
2021,363,Longwood,11,15,0,26
2021,364,Loras,6,3,0,9
2021,671,Louisiana,15,7,0,22
2021,1182,Louisiana Col.,6,4,0,10
2021,366,Louisiana Tech,17,6,0,23
2021,367,Louisville,12,5,0,17
2021,371,Loyola Chicago,19,4,0,23
2021,369,Loyola Maryland,4,8,0,12
2021,365,LSU,14,7,0,21
2021,30177,Lubbock Christian,16,0,0,16
2021,372,Luther,1,5,0,6
2021,373,Lycoming,2,0,0,2
2021,374,Lynchburg,4,3,0,7
2021,380,Maine,2,7,0,9
2021,378,Maine Maritime,0,1,0,1
2021,30137,Malone,12,7,0,19
2021,1192,Manchester,3,9,0,12
2021,381,Manhattan,6,9,0,15
2021,382,Manhattanville,0,2,0,2
2021,1194,Maranatha Baptist,7,7,0,14
2021,1196,Marian (WI),2,7,0,9
2021,385,Marietta,7,1,0,8
2021,386,Marist,10,8,0,18
2021,387,Marquette,11,12,0,23
2021,1199,Mars Hill,2,16,0,18
2021,388,Marshall,12,5,0,17
2021,8597,Martin Luther,1,9,0,10
2021,30075,Mary,4,12,0,16
2021,1203,Mary Hardin-Baylor,12,6,0,18
2021,392,Maryland,14,10,0,24
2021,394,Marymount (VA),1,1,0,2
2021,395,Maryville (MO),7,11,0,18
2021,396,Maryville (TN),7,1,0,8
2021,400,Massachusetts,7,5,0,12
2021,30138,McKendree,9,10,0,19
2021,8530,McMurry,4,15,0,19
2021,402,McNeese,9,11,0,20
2021,379,Me.-Farmington,1,0,0,1
2021,30040,Me.-Presque Isle,0,2,0,2
2021,404,Memphis,13,6,0,19
2021,406,Mercer,15,9,0,24
2021,724,Merchant Marine,0,2,0,2
2021,407,Mercy,1,5,0,6
2021,408,Mercyhurst,10,1,0,11
2021,410,Merrimack,8,6,0,14
2021,411,Messiah,1,3,0,4
2021,412,Methodist,5,4,0,9
2021,415,Miami (FL),7,14,0,21
2021,414,Miami (OH),10,9,0,19
2021,418,Michigan,16,1,0,17
2021,416,Michigan St.,12,9,0,21
2021,417,Michigan Tech,10,6,0,16
2021,419,Middle Tenn.,5,13,0,18
2021,422,Miles,5,1,0,6
2021,424,Millikin,1,9,0,10
2021,426,Millsaps,1,6,0,7
2021,797,Milwaukee,8,11,0,19
2021,427,Minn. Duluth,6,7,0,13
2021,27854,Minn.-Crookston,2,14,0,16
2021,1226,Minn.-Morris,3,4,0,7
2021,428,Minnesota,13,10,0,23
2021,383,Minnesota St.,10,6,0,16
2021,30125,Minot St.,8,6,0,14
2021,429,Mississippi Col.,2,6,0,8
2021,430,Mississippi St.,13,11,0,24
2021,432,Mississippi Val.,1,18,0,19
2021,434,Missouri,14,7,0,21
2021,435,Missouri S&T,4,15,0,19
2021,669,Missouri St.,15,5,0,20
2021,9013,Missouri Western,12,9,0,21
2021,9012,Mo. Southern St.,12,8,0,20
2021,436,Mo.-St. Louis,12,4,0,16
2021,437,Molloy,3,5,0,8
2021,439,Monmouth,10,7,0,17
2021,441,Montana,9,12,0,21
2021,440,Montana St.,9,7,0,16
2021,442,Montclair St.,5,1,0,6
2021,1238,Montevallo,6,8,0,14
2021,443,Moravian,1,8,0,9
2021,444,Morehead St.,18,7,0,25
2021,446,Morgan St.,11,6,0,17
2021,30036,Mount Aloysius,0,1,0,1
2021,1245,Mount Olive,5,9,0,14
2021,452,Mount Union,6,3,0,9
2021,20220,MSOE,6,5,0,11
2021,413,MSU Denver,8,6,0,14
2021,1240,MSU Moorhead,9,3,0,12
2021,1222,Midwestern St.,9,8,0,17
2021,8567,Mt. St. Joseph,2,10,0,12
2021,450,Mount St. Mary's,9,10,0,19
2021,454,Murray St.,13,10,0,23
2021,455,Muskingum,4,6,0,10
2021,431,MUW,0,3,0,3
2021,488,N.C. A&T,10,10,0,20
2021,489,N.C. Central,4,6,0,10
2021,491,N.C. Wesleyan,10,7,0,17
2021,726,Navy,13,2,0,15
2021,461,Nazareth,0,0,1,1
2021,490,NC State,11,9,0,20
2021,462,Neb. Wesleyan,2,2,0,4
2021,1156,Neb.-Kearney,8,12,0,20
2021,463,Nebraska,5,16,0,21
2021,1254,Neumann,0,0,1,1
2021,466,Nevada,14,7,0,21
2021,467,New England Col.,0,2,0,2
2021,469,New Hampshire,10,8,0,18
2021,319,New Jersey City,3,1,0,4
2021,473,New Mexico,6,14,0,20
2021,472,New Mexico St.,6,6,0,12
2021,474,New Orleans,6,13,0,19
2021,1257,Newberry,9,6,0,15
2021,30054,Newman,3,18,0,21
2021,482,Niagara,8,10,0,18
2021,483,Nicholls St.,14,6,0,20
2021,471,NJIT,7,11,0,18
2021,485,Norfolk St.,13,7,0,20
2021,487,North Ala.,10,10,0,20
2021,457,North Carolina,14,8,0,22
2021,492,North Central (IL),5,4,0,9
2021,30039,North Central (MN),8,5,0,13
2021,494,North Dakota,9,16,0,25
2021,493,North Dakota St.,12,10,0,22
2021,2711,North Florida,7,13,0,20
2021,30052,North Georgia,2,10,0,12
2021,9223,North Greenville,8,6,0,14
2021,496,North Park,2,10,0,12
2021,497,North Texas,12,6,0,18
2021,500,Northeastern,9,8,0,17
2021,12810,Northeastern St.,4,17,0,21
2021,501,Northern Ariz.,5,14,0,19
2021,502,Northern Colo.,9,8,0,17
2021,503,Northern Ill.,2,14,0,16
2021,505,Northern Ky.,13,10,0,23
2021,506,Northern Mich.,8,8,0,16
2021,1266,Northern St.,15,1,0,16
2021,1267,Northland,0,6,0,6
2021,507,Northwest Mo. St.,19,1,0,20
2021,1274,Northwest Nazarene,10,1,0,11
2021,509,Northwestern,6,14,0,20
2021,30178,Northwestern Okla.,2,10,0,12
2021,508,Northwestern St.,8,15,0,23
2021,30031,Northwestern-St. Paul,8,2,0,10
2021,510,Northwood,6,10,0,16
2021,513,Notre Dame,9,12,0,21
2021,30126,Notre Dame (OH),7,8,0,15
2021,324,NVU-Johnson,0,3,0,3
2021,30065,NVU-Lyndon,1,3,0,4
2021,1277,Nyack,4,4,0,8
2021,514,Oakland,10,17,0,27
2021,2713,Oglethorpe,6,1,0,7
2021,519,Ohio,12,6,0,18
2021,30119,Ohio Dominican,5,12,0,17
2021,517,Ohio Northern,3,4,0,7
2021,518,Ohio St.,18,5,0,23
2021,15207,Ohio Valley,3,14,0,17
2021,520,Ohio Wesleyan,3,3,0,6
2021,30202,Okla. Baptist,12,4,0,16
2021,30179,Okla. Christian,5,11,0,16
2021,522,Oklahoma,14,6,0,20
2021,521,Oklahoma St.,15,6,0,21
2021,523,Old Dominion,12,6,0,18
2021,433,Ole Miss,13,9,0,22
2021,525,Olivet,2,14,0,16
2021,464,Omaha,3,19,0,22
2021,527,Oral Roberts,11,10,0,21
2021,529,Oregon,14,5,0,19
2021,528,Oregon St.,11,11,0,22
2021,531,Otterbein,2,4,0,6
2021,1289,Ouachita Baptist,4,9,0,13
2021,23008,Ozarks (AR),4,5,0,9
2021,534,Pacific,8,7,0,15
2021,1297,Pacific Lutheran,5,1,0,6
2021,30045,Palm Beach Atl.,2,1,0,3
2021,539,Penn St.,8,12,0,20
2021,541,Pepperdine,10,10,0,20
2021,542,Pfeiffer,6,2,0,8
2021,21830,Piedmont,10,8,0,18
2021,1314,Pittsburg St.,10,10,0,20
2021,545,Pittsburgh,9,9,0,18
2021,548,Plymouth St.,0,2,0,2
2021,30149,Point Loma,6,1,0,7
2021,551,Portland,6,14,0,20
2021,550,Portland St.,8,9,0,17
2021,553,Prairie View,9,4,0,13
2021,1320,Presbyterian,7,14,0,21
2021,556,Providence,12,11,0,23
2021,557,Puget Sound,2,8,0,10
2021,559,Purdue,15,8,0,23
2021,308,Purdue Fort Wayne,7,14,0,21
2021,30222,Purdue Northwest,8,11,0,19
2021,11504,Queens (NC),14,5,0,19
2021,561,Quincy,6,16,0,22
2021,562,Quinnipiac,8,9,0,17
2021,563,Radford,14,11,0,25
2021,566,Randolph,3,6,0,9
2021,565,Randolph-Macon,6,0,0,6
2021,568,Regis (CO),5,11,0,16
2021,572,Rhode Island,10,13,0,23
2021,571,Rhode Island Col.,1,6,0,7
2021,573,Rhodes,1,6,0,7
2021,574,Rice,12,10,0,22
2021,575,Richmond,13,5,0,18
2021,576,Rider,4,13,0,17
2021,578,Roanoke,7,1,0,8
2021,579,Robert Morris,4,14,0,18
2021,30150,Roberts Wesleyan,6,6,0,12
2021,581,Rochester (NY),0,1,0,1
2021,582,Rockford,6,3,0,9
2021,1328,Rockhurst,9,11,0,20
2021,30180,Rogers St.,11,11,0,22
2021,585,Rose-Hulman,10,2,0,12
2021,587,Rutgers,13,9,0,22
2021,588,Rutgers-Camden,0,6,0,6
2021,589,Rutgers-Newark,2,2,0,4
2021,11276,USC Aiken,9,6,0,15
2021,102,Sacramento St.,7,8,0,15
2021,590,Sacred Heart,8,7,0,15
2021,591,Saginaw Valley,3,11,0,14
2021,600,Saint Francis (PA),6,15,0,21
2021,602,Saint John's (MN),3,1,0,4
2021,606,Saint Joseph's,3,14,0,17
2021,608,Saint Leo,2,1,0,3
2021,609,Saint Louis,11,5,0,16
2021,1343,Saint Martin's,1,8,0,9
2021,610,Saint Mary's (CA),12,7,0,19
2021,612,Saint Mary's (MN),5,2,0,7
2021,617,Saint Peter's,11,8,0,19
2021,1347,Saint Rose,2,2,0,4
2021,30064,Saint Vincent,2,5,0,7
2021,19117,Salem (WV),4,5,0,9
2021,622,Salisbury,4,3,0,7
2021,624,Sam Houston,17,7,0,24
2021,625,Samford,6,12,0,18
2021,627,San Diego,3,9,0,12
2021,626,San Diego St.,17,4,0,21
2021,629,San Francisco,10,11,0,21
2021,630,San Jose St.,5,15,0,20
2021,631,Santa Clara,10,6,0,16
2021,1355,Schreiner,2,4,0,6
2021,633,Scranton,4,2,0,6
2021,634,Seattle Pacific,7,3,0,10
2021,1356,Seattle U,9,8,0,17
2021,635,Seton Hall,13,10,0,23
2021,652,Sewanee,0,3,0,3
2021,676,SFA,14,3,0,17
2021,637,Shenandoah,0,7,0,7
2021,30151,Shorter,4,11,0,15
2021,639,Siena,9,3,0,12
2021,641,Simpson,2,5,0,7
2021,30128,Sioux Falls,7,5,0,12
2021,660,SIUE,8,15,0,23
2021,663,SMU,11,4,0,15
2021,646,South Alabama,16,8,0,24
2021,648,South Carolina,5,12,0,17
2021,647,South Carolina St.,0,15,0,15
2021,650,South Dakota,12,9,0,21
2021,30139,South Dakota Mines,8,9,0,17
2021,649,South Dakota St.,13,6,0,19
2021,651,South Fla.,8,9,0,17
2021,654,Southeast Mo. St.,9,15,0,24
2021,655,Southeastern La.,7,14,0,21
2021,1371,Southeastern Okla.,7,8,0,15
2021,1376,Southern Ark.,11,4,0,15
2021,657,Southern California,19,4,0,23
2021,659,Southern Ill.,11,11,0,22
2021,661,Southern Ind.,11,4,0,15
2021,662,Southern Me.,2,0,0,2
2021,664,Southern Miss.,8,14,0,22
2021,30152,Southern Nazarene,9,7,0,16
2021,665,Southern U.,7,8,0,15
2021,667,Southern Utah,16,3,0,19
2021,30164,Southern Va.,0,1,0,1
2021,30192,Southern Wesleyan,9,6,0,15
2021,2755,Southwest Baptist,14,5,0,19
2021,8736,Southwest Minn. St.,3,8,0,11
2021,8746,Southwestern (TX),4,2,0,6
2021,8744,Southwestern Okla.,7,8,0,15
2021,30191,Spring Hill,1,6,0,7
2021,596,St. Bonaventure,12,3,0,15
2021,598,St. Cloud St.,8,8,0,16
2021,1334,St. Edward's,9,6,0,15
2021,599,St. Francis Brooklyn,8,9,0,17
2021,603,St. John's (NY),14,10,0,24
2021,611,St. Mary's (MD),1,6,0,7
2021,1346,St. Mary's (TX),3,8,0,11
2021,618,St. Scholastica,6,0,0,6
2021,620,St. Thomas (MN),3,0,0,3
2021,1348,St. Thomas Aquinas,10,0,0,10
2021,674,Stanford,14,9,0,23
2021,678,Stetson,9,12,0,21
2021,21852,Stevenson,1,3,0,4
2021,681,Stockton,3,3,0,6
2021,683,Stony Brook,9,13,0,22
2021,1390,Sul Ross St.,8,11,0,19
2021,688,Syracuse,13,7,0,20
2021,689,Tampa,1,2,0,3
2021,1395,Tarleton St.,7,9,0,16
2021,712,TCNJ,6,0,0,6
2021,698,TCU,11,10,0,21
2021,690,Temple,5,10,0,15
2021,694,Tennessee,16,6,0,22
2021,691,Tennessee St.,4,17,0,21
2021,692,Tennessee Tech,3,22,0,25
2021,30090,Tex. A&M Int'l,1,13,0,14
2021,199,Tex. A&M-Commerce,6,6,0,12
2021,696,Tex. A&M-Kingsville,13,2,0,15
2021,30088,Tex. Permian Basin,8,11,0,19
2021,703,Texas,14,6,0,20
2021,697,Texas A&M,8,7,0,15
2021,1400,Texas Lutheran,3,5,0,8
2021,699,Texas Southern,8,8,0,16
2021,670,Texas St.,16,6,0,22
2021,700,Texas Tech,14,8,0,22
2021,23121,Texas-Dallas,7,3,0,10
2021,30028,Texas-Tyler,8,9,0,17
2021,141,The Citadel,12,11,0,23
2021,707,Thiel,1,2,0,3
2021,1403,Tiffin,5,14,0,19
2021,709,Toledo,18,6,0,24
2021,711,Towson,4,13,0,17
2021,28749,Transylvania,7,8,0,15
2021,30002,Trevecca Nazarene,5,16,0,21
2021,30037,Trine,13,0,0,13
2021,715,Trinity (TX),6,1,0,7
2021,716,Troy,10,14,0,24
2021,499,Truman,16,2,0,18
2021,718,Tulane,9,10,0,19
2021,719,Tulsa,10,10,0,20
2021,12830,Tusculum,12,5,0,17
2021,720,Tuskegee,4,6,0,10
2021,1255,U New England,0,2,0,2
2021,9,UAB,18,5,0,23
2021,108,UC Davis,6,6,0,12
2021,109,UC Irvine,12,8,0,20
2021,111,UC Riverside,10,6,0,16
2021,112,UC San Diego,5,8,0,13
2021,104,UC Santa Barbara,16,3,0,19
2021,9754,UC-Colo. Springs,7,8,0,15
2021,128,UCF,8,11,0,19
2021,110,UCLA,16,5,0,21
2021,164,UConn,11,6,0,17
2021,302,UIC,9,12,0,21
2021,309,UIndy,9,10,0,19
2021,656,UMass Dartmouth,6,2,0,8
2021,368,UMass Lowell,8,11,0,19
2021,391,UMBC,14,5,0,19
2021,2707,Kansas City,11,10,0,21
2021,456,UNC Asheville,10,9,0,19
2021,459,UNC Greensboro,17,8,0,25
2021,537,UNC Pembroke,3,3,0,6
2021,460,UNCW,7,8,0,15
2021,504,UNI,7,15,0,22
2021,30153,Union (TN),10,6,0,16
2021,465,UNLV,10,12,0,22
2021,728,Upper Iowa,10,6,0,16
2021,10411,USC Upstate,5,17,0,22
2021,702,UT Arlington,11,12,0,23
2021,695,UT Martin,7,15,0,22
2021,732,Utah,9,10,0,19
2021,731,Utah St.,14,7,0,21
2021,30024,Utah Valley,8,9,0,17
2021,704,UTEP,10,10,0,20
2021,536,UTRGV,9,4,0,13
2021,706,UTSA,12,9,0,21
2021,30181,UVa-Wise,5,13,0,18
2021,745,Va. Wesleyan,3,3,0,6
2021,734,Valdosta St.,12,4,0,16
2021,30166,Valley Forge,0,2,0,2
2021,735,Valparaiso,9,16,0,25
2021,736,Vanderbilt,6,13,0,19
2021,740,VCU,17,5,0,22
2021,738,Vermont,10,4,0,14
2021,739,Villanova,15,3,0,18
2021,746,Virginia,15,6,0,21
2021,742,Virginia Tech,14,5,0,19
2021,741,VMI,12,11,0,23
2021,747,Wabash,3,4,0,7
2021,748,Wagner,10,5,0,15
2021,749,Wake Forest,6,12,0,18
2021,30141,Walsh,8,8,0,16
2021,750,Wartburg,3,6,0,9
2021,751,Wash. & Jeff.,5,1,0,6
2021,752,Wash. & Lee,4,1,0,5
2021,2814,Washburn,15,6,0,21
2021,756,Washington,5,18,0,23
2021,754,Washington St.,14,10,0,24
2021,757,Wayne St. (MI),11,4,0,15
2021,1433,Wayne St. (NE),10,6,0,16
2021,1434,Waynesburg,2,4,0,6
2021,758,Weber St.,14,5,0,19
2021,759,Webster,0,1,0,1
2021,358,West Ala.,6,5,0,11
2021,11740,West Florida,7,10,0,17
2021,766,West Ga.,12,6,0,18
2021,1438,West Liberty,12,3,0,15
2021,767,West Tex. A&M,11,1,0,12
2021,9630,West Va. Wesleyan,0,14,0,14
2021,768,West Virginia,16,6,0,22
2021,1439,West Virginia St.,9,5,0,14
2021,769,Western Caro.,10,15,0,25
2021,771,Western Ill.,7,12,0,19
2021,772,Western Ky.,15,4,0,19
2021,774,Western Mich.,4,13,0,17
2021,1445,Western N.M.,0,8,0,8
2021,2759,Western Colo.,6,10,0,16
2021,1451,Westminster (PA),6,1,0,7
2021,30209,Westminster (UT),8,12,0,20
2021,778,Wheaton (IL),9,0,0,9
2021,12799,Wheeling,4,10,0,14
2021,780,Whitman,2,4,0,6
2021,1454,Whitworth,7,4,0,11
2021,782,Wichita St.,13,4,0,17
2021,783,Widener,3,1,0,4
2021,784,Wilkes,1,3,0,4
2021,786,William & Mary,6,9,0,15
2021,30120,William Jewell,4,17,0,21
2021,17094,William Peace,2,10,0,12
2021,1461,Wilmington (OH),3,7,0,10
2021,1462,Wingate,10,9,0,19
2021,790,Winona St.,7,6,0,13
2021,792,Winthrop,20,1,0,21
2021,8911,Wis. Lutheran,7,1,0,8
2021,793,Wis.-Eau Claire,2,3,0,5
2021,795,Wis.-La Crosse,6,1,0,7
2021,798,Wis.-Oshkosh,4,1,0,5
2021,799,Wis.-Parkside,9,7,0,16
2021,800,Wis.-Platteville,5,2,0,7
2021,801,UW-River Falls,3,3,0,6
2021,802,Wis.-Stevens Point,2,5,0,7
2021,803,Wis.-Stout,2,5,0,7
2021,804,Wis.-Superior,2,2,0,4
2021,805,Wis.-Whitewater,1,5,0,6
2021,796,Wisconsin,16,8,0,24
2021,806,Wittenberg,0,4,0,4
2021,787,Wm. Paterson,0,2,0,2
2021,2915,Wofford,14,8,0,22
2021,807,Wooster,1,2,0,3
2021,810,Wright St.,18,5,0,23
2021,811,Wyoming,12,9,0,21
2021,812,Xavier,12,5,0,17
2021,814,Yeshiva,4,0,0,4
2021,30154,Young Harris,5,6,1,12
2021,817,Youngstown St.,14,11,0,25
